XXXXXXXXXXX
XOOOOOOOOOX
XOXOOOOOOOX
XOOOOOOOOOX
XOOOOOOOOOX
XOOOOOOOOOX
XOOOOOOOOOX
XOOOOOOOOOX
XOOOOOOOOOX
XOOOOOOOOOX
XOOOOOOOOOX
XXXXXXXXXXX
