XXXXXXXXXXXXXXXXXXXXXXXXXXXX
XOOOOOOOOOOOOOOOOOOOOOOOOOOX
XOXXXXXXXXXXOXXOXXXXXXXXXXOX
XOOOOOOXXOOOOXXOOOOXXOOOOOOX
XXXOXXOXXOXXXXXXXXOXXOXXOXXX
X*OOXXOOOOOOOOOOOOOOOOXXOO*X
XOXXXXOXXXXXOXXOXXXXXOXXXXOX
XOOOOOOOOOOOOXXOOOOOOOOOOOOX
XXXXXXOXXOXXXXXXXXOXXOXXXXXX
     XOXXOOOOOOOOOOXXOX
     XOXXOXXXXXXXXOXXOX
XXXXXXOXXOX      XOXXOXXXXXX
 OOOOOOOOOX      XOOOOOOOOO
XXXXXXOXXOX      XOXXOXXXXXX
     XOXXOXXX  XXXOXXOX
     XOXXOOOOOOOOOOXXOX
XXXXXXOXXXXXOXXOXXXXXOXXXXXX
XOOOOOOXXOOOOXXOOOOXXOOOOOOX
XOXXXXOXXOXXXXXXXXOXXOXXXXOX
XOOOOOOOOOOOOOOOOOOOOOOOOOOX
XOXXXXOXXXXXOXXOXXXXXOXXXXOX
X*XXXXOXXXXXOXXOXXXXXOXXXX*X
XOOOOOOOOOOOOXXOOOOOOOOOOOOX
XXXXXXXXXXXXXXXXXXXXXXXXXXXX

